[管线大类]
DL
DX
JS
PS
RQ
RL
GY
ZH
BM
[DL]
供电=GD
路灯=LD
交通信号=XH
[DX]
通信=TX
电视=TV
军用=JY
监控=JK
[JS]
原水=YJ
配水=JP
中水=ZS
直饮水=ZY
消防水=XF
饮用水=SS
循环水=XS
[PS]
雨水=YS
污水=WS
雨污合流=HS
[RQ]
天然气=TR
[RL]
蒸汽=ZQ
热水=RS
[GY]
氢=QQ
氧=YY
乙炔=YQ
石油=SY
灰水=GH
航空煤油=MY
其他=QT
[ZH]
综合管廊=ZH
[BM]
不明管线=BM